==================================
CLASS
==================================
SparkFun_5P49V60	KEYWORD1

==================================
FUNCTIONS
==================================
begin	KEYWORD2
setVcoFrequency	KEYWORD2
setClockOneFreq	KEYWORD2
setClockTwoFreq	KEYWORD2
setClockThrFreq	KEYWORD2
setClockFourFreq	KEYWORD2
skewClockOne	KEYWORD2
skewClockTwo	KEYWORD2
skewClockThr	KEYWORD2
skewClockFour	KEYWORD2
changeI2CAddress	KEYWORD2
readI2CAddress	KEYWORD2
readBurnedBit	KEYWORD2
xtalControl	KEYWORD2
clockInControl	KEYWORD2
doubleRefFreqControl	KEYWORD2
refModeControl	KEYWORD2
sdInputPinControl	KEYWORD2
globalSdControl	KEYWORD2
persEnableClock	KEYWORD2
clockZeroSlewRate	KEYWORD2
clockZeroPwrSel	KEYWORD2
addCrystalLoadCap	KEYWORD2
readCrystalCapVal	KEYWORD2
changeSource	KEYWORD2
readSource	KEYWORD2
selectRefDivider	KEYWORD2
readRefDivider	KEYWORD2
bypassRefDivider	KEYWORD2
readBypassDivider	KEYWORD2
vcoTestControl	KEYWORD2
readTestControl	KEYWORD2
setPllFeedbackIntDiv	KEYWORD2
readPllFeedBackIntDiv	KEYWORD2
setSigmaDeltaMod	KEYWORD2
setPllFeedBackFractDiv	KEYWORD2
readPllFeedBackFractDiv	KEYWORD2
calibrateVco	KEYWORD2
setPllFilterResOne	KEYWORD2
setPllFilterCapOne	KEYWORD2
setPllFilterResTwo	KEYWORD2
bypassPllFilterThree	KEYWORD2
setPllFilterCapTwo	KEYWORD2
setPllFilterChargePump	KEYWORD2
readPllFilterResOne	KEYWORD2
readPllFilterCapOne	KEYWORD2
readPllFilterResTwo	KEYWORD2
readPllFilterCapTwo	KEYWORD2
bypassThirdFilter	KEYWORD2
resetFodOne	KEYWORD2
muxPllToFodOne	KEYWORD2
muxRefClockToOutOne	KEYWORD2
muxRefClockToFodOne	KEYWORD2
integerModeOne	KEYWORD2
setIntDivSkewOne	KEYWORD2
setFractDivSkewOne	KEYWORD2
readIntDivSkewOne	KEYWORD2
readFractDivSkewOne	KEYWORD2
auxControlOne	KEYWORD2
setFractDivFodOne	KEYWORD2
readFractDivFodOne	KEYWORD2
setIntDivOutOne	KEYWORD2
readIntDivOutOne	KEYWORD2
resetFodTwo	KEYWORD2
muxPllToFodTwo	KEYWORD2
muxOutOneToOutTwo	KEYWORD2
muxFodOneToFodTwo	KEYWORD2
integerModeTwo	KEYWORD2
setFractDivFodTwo	KEYWORD2
readFractDivFodTwo	KEYWORD2
setIntDivSkewTwo	KEYWORD2
setFractDivSkewTwo	KEYWORD2
readIntDivSkewTwo	KEYWORD2
readFractDivSkewTwo	KEYWORD2
auxControlTwo	KEYWORD2
setIntDivOutTwo	KEYWORD2
readIntDivOutTwo	KEYWORD2
resetFodThree	KEYWORD2
muxPllToFodThree	KEYWORD2
muxOutTwoToOutThree	KEYWORD2
muxOutTwoToFodThree	KEYWORD2
integerModeThree	KEYWORD2
setFractDivFodThr	KEYWORD2
readFractDivFodThr	KEYWORD2
setIntDivSkewThr	KEYWORD2
setFractDivSkewThr	KEYWORD2
readIntDivSkewThr	KEYWORD2
readFractDivSkewThr	KEYWORD2
auxControlThree	KEYWORD2
setIntDivOutThree	KEYWORD2
readIntDivOutThree	KEYWORD2
resetFodFour	KEYWORD2
muxPllToFodFour	KEYWORD2
muxOutThreeToOutFour	KEYWORD2
muxOutThreeToFodFour	KEYWORD2
integerModeFour	KEYWORD2
setFractDivFodFour	KEYWORD2
readFractDivFodFour	KEYWORD2
setIntDivSkewFour	KEYWORD2
setFractDivSkewFour	KEYWORD2
readIntDivSkewFour	KEYWORD2
readFractDivSkewFour	KEYWORD2
auxControlFour	KEYWORD2
setIntDivOutFour	KEYWORD2
readIntDivOutFour	KEYWORD2
clockOneConfigMode	KEYWORD2
clockOneSlew	KEYWORD2
clockOneControl	KEYWORD2
resetClockOne	KEYWORD2
clockTwoControl	KEYWORD2
resetClockTwo	KEYWORD2
clockTwoConfigMode	KEYWORD2
clockThrControl	KEYWORD2
clockThrConfigMode	KEYWORD2
clockFourControl	KEYWORD2
clockFourConfigMode	KEYWORD2
globalReset	KEYWORD2
_readRegister	KEYWORD2

==================================
CONSTANTS
==================================
DEF_ADDR	LITERAL1
ALT_ADDR	LITERAL1
ALT	LITERAL1
DEF	LITERAL1
SLOWEST	LITERAL1
SLOW	LITERAL1
FAST	LITERAL1
FASTEST	LITERAL1
DISABLE	LITERAL1
ENABLE	LITERAL1
XIN	LITERAL1
XOUT	LITERAL1
ERROR	LITERAL1
CLOCK_SOURCE	LITERAL1
XTAL_SOURCE	LITERAL1
LVPECL_MODE	LITERAL1
CMOS_MODE	LITERAL1
HCSL33_MODE	LITERAL1
LVDS_MODE	LITERAL1
CMOS2_MODE	LITERAL1
CMOSD_MODE	LITERAL1
HCSL25_MODE	LITERAL1
OTP_CONTROL_REG	LITERAL1
SHUTDOWN_REG	LITERAL1
VCO_BAND_REG	LITERAL1
LOAD_CAP_REG_ONE	LITERAL1
LOAD_CAP_REG_TWO	LITERAL1
REF_DIVIDER_REG	LITERAL1
DIVIDER_VCO_REG	LITERAL1
FDB_INT_DIV_REG_ONE	LITERAL1
FDB_INT_DIV_REG_TWO	LITERAL1
FDB_FRAC_DIV_REG_ONE	LITERAL1
FDB_FRAC_DIV_REG_TWO	LITERAL1
FDB_FRAC_DIV_REG_THR	LITERAL1
VC_CONTROL_REG	LITERAL1
RC_CONTR_REG_ONE	LITERAL1
RC_CONTR_REG_TWO	LITERAL1
RC_CONTR_REG_THR	LITERAL1
DIV_ONE_CONTROL_REG	LITERAL1
OUT_FDIV_REG_ONE	LITERAL1
OUT_FDIV_REG_TWO	LITERAL1
OUT_FDIV_REG_THR	LITERAL1
OUT_FDIV_REG_FOUR	LITERAL1
OUT_STEP_SPRD_REG_ONE	LITERAL1
OUT_STEP_SPRD_REG_TWO	LITERAL1
OUT_STEP_SPRD_REG_THR	LITERAL1
OUT_SPRD_RATE_REG_ONE	LITERAL1
OUT_SPRD_RATE_REG_TWO	LITERAL1
OUT_ISKEW_REG_ONE	LITERAL1
OUT_ISKEW_REG_TWO	LITERAL1
OUT_IDIV_REG_ONE	LITERAL1
OUT_IDIV_REG_TWO	LITERAL1
OUT_FSKEW_REG	LITERAL1
DIV_TWO_CONTROL_REG	LITERAL1
OUT_FDIV_TWO_REG_ONE	LITERAL1
OUT_FDIV_TWO_REG_TWO	LITERAL1
OUT_FDIV_TWO_REG_THR	LITERAL1
OUT_FDIV_TWO_REG_FOUR	LITERAL1
OUT_STEP_SPRD_TWO_REG_ONE	LITERAL1
OUT_STEP_SPRD_TWO_REG_TWO	LITERAL1
OUT_STEP_SPRD_TWO_REG_THR	LITERAL1
OUT_SPRD_RATE_TWO_REG_ONE	LITERAL1
OUT_SPRD_RATE_TWO_REG_TWO	LITERAL1
OUT_ISKEW_TWO_REG_ONE	LITERAL1
OUT_ISKEW_TWO_REG_TWO	LITERAL1
OUT_IDIV_TWO_REG_ONE	LITERAL1
OUT_IDIV_TWO_REG_TWO	LITERAL1
OUT_FSKEW_TWO_REG	LITERAL1
DIV_THR_CONTROL_REG	LITERAL1
OUT_FDIV_THR_REG_ONE	LITERAL1
OUT_FDIV_THR_REG_TWO	LITERAL1
OUT_FDIV_THR_REG_THR	LITERAL1
OUT_FDIV_THR_REG_FOUR	LITERAL1
OUT_STEP_SPRD_FOUR_REG_ONE	LITERAL1
OUT_STEP_SPRD_FOUR_REG_TWO	LITERAL1
OUT_STEP_SPRD_FOUR_REG_THR	LITERAL1
OUT_SPRD_RATE_FOUR_REG_ONE	LITERAL1
OUT_SPRD_RATE_FOUR_REG_TWO	LITERAL1
OUT_ISKEW_THR_REG_ONE	LITERAL1
OUT_ISKEW_THR_REG_TWO	LITERAL1
OUT_IDIV_THR_REG_ONE	LITERAL1
OUT_IDIV_THR_REG_TWO	LITERAL1
OUT_FSKEW_THR_REG	LITERAL1
DIV_FOUR_CONTROL_REG	LITERAL1
OUT_FDIV_FOUR_REG_ONE	LITERAL1
OUT_FDIV_FOUR_REG_TWO	LITERAL1
OUT_FDIV_FOUR_REG_THR	LITERAL1
OUT_FDIV_FOUR_REG_FOUR	LITERAL1
OUT_ISKEW_FOUR_REG_ONE	LITERAL1
OUT_ISKEW_FOUR_REG_TWO	LITERAL1
OUT_IDIV_FOUR_REG_ONE	LITERAL1
OUT_IDIV_FOUR_REG_TWO	LITERAL1
OUT_FSKEW_FOUR_REG	LITERAL1
CLK_ONE_OUT_CNFIG_REG_ONE	LITERAL1
CLK_ONE_OUT_CNFIG_REG_TWO	LITERAL1
CLK_TWO_OUT_CNFIG_REG_ONE	LITERAL1
CLK_TWO_OUT_CNFIG_REG_TWO	LITERAL1
CLK_THR_OUT_CNFIG_REG_ONE	LITERAL1
CLK_THR_OUT_CNFIG_REG_TWO	LITERAL1
CLK_FOUR_OUT_CNFIG_REG_ONE	LITERAL1
CLK_FOUR_OUT_CNFIG_REG_TWO	LITERAL1
CLK_OE_FUNC_REG	LITERAL1
CLK_OS_FUNC_REG	LITERAL1
GLOBAL_RESET_REG	LITERAL1
MASK_ONE	LITERAL1
MASK_TWO	LITERAL1
MASK_THREE	LITERAL1
MASK_FOUR	LITERAL1
MASK_FIVE	LITERAL1
MASK_SIX	LITERAL1
MASK_SEVEN	LITERAL1
MASK_EIGHT	LITERAL1
MASK_NINE	LITERAL1
MASK_TEN	LITERAL1
MASK_ELEVEN	LITERAL1
MASK_TWELVE	LITERAL1
MASK_THIRT	LITERAL1
MASK_FOURT	LITERAL1
MASK_FIFT	LITERAL1
MASK_FIFT_MSB	LITERAL1
MASK_THIRT_MSB	LITERAL1
MASK_EIGHT_MSB	LITERAL1
MASK_FOUR_MSB	LITERAL1
MASK_THR_MSB	LITERAL1
MASK_TWO_MSB	LITERAL1
MASK_ONE_MSB	LITERAL1
MASK_ALL	LITERAL1
MASK_ALL_8_BIT	LITERAL1
MASK_ALL_12_BIT	LITERAL1
MASK_ALL_16_BIT	LITERAL1
MASK_ALL_24_BIT	LITERAL1
MASK_ENDS	LITERAL1
POS_ZERO	LITERAL1
POS_ONE	LITERAL1
POS_TWO	LITERAL1
POS_THREE	LITERAL1
POS_FOUR	LITERAL1
POS_FIVE	LITERAL1
POS_SIX	LITERAL1
POS_SEVEN	LITERAL1
POS_EIGHT	LITERAL1
POS_FIFT	LITERAL1
POS_SIXT	LITERAL1

==================================
DATA TYPES
==================================
REGISTER_INDEX	KEYWORD1
MASK_INDEX	KEYWORD1
BIT_POS_INDEX	KEYWORD1
